111111111111111111111111
1000C000000P000000000001
10000000C000000000000001
10000000000000000E000001
111111111111111111111111