11111111111
10001000C01
100000E0001
10C11001001
11111111111