11111111111111111111111111111111111111111111
110000011111100000001110000000000000111111E1
11110001101000011111111110000001111111110001
11100000000001111000011000011100001111111001
10000001100000000000000000001100000000000011
11000001111000000000111110000000111111000001
1P000000011100001110001110000000011100000011
11111111111111111111111111111111111111111111