11111111111111111111111111111111111111111111
1C0000011111100000001110000000000000111111E1
11110001111000011111111110000001111111110001
111000000000011110000C1000011100001111111001
10000001100000000000000000001100000000000011
11000001111C00000000111110000000111111000001
1P0000000111000011100011100000000111000000C1
11111111111111111111111111111111111111111111